                                                              +
                                                              +
                                                              +
                                                              +
                                                              +
                                                              +
                                                              +
                                                              +
                                                              +
                                                              +
                                                              +
                                                              +
                         ++++++++++++++                       +
                       ++++++++++++++++++                     +
                      ++++++++++++++++++++                    +
                     ++++++++++++++++++++++                   +
                    ++++++++++++++++++++++++                  +
                    +++++   +++++    +++++++                  +
                    ++++ ++  +++  ++  ++++++                  +
                    ++++ ++  +++  ++  ++++++                  +
                     +++  ++ ++++++   ++++++                  +
                      +++           ++++++++                  +
                      +++           +++++++                   +
                      ++++           ++++++++                 +
                      +++             ++++++++                +
                     +++              ++++++++                +
                   ++++                 +++++++++             +
                  ++++                    +++++++++           +
                +++++                      +++++++++          +
               +++++++-++             ++-++++++++++++         +
              +++++                          ++++++++++       +
             +++++                            ++++++++++      +
            +++++                             ++++++++++      +
            ++++                               ++++++++++     +
           +++++                               +++++++++++    +
          +++++                                +++++++++++    +
         ++++++                                +++++++++++    +
         +++++++                               +++++++++++    +
         ++++++++                             +++++++++++     +
        +     +++++                            +++++++++      +
   ++ +         +++++++                      +++++++++++++    +
 +               ++++++++                   ++   ++++++   +   +
 +                ++++++++                                + +++
  +                                     ++++                  +
                     ++               +++++                   +
                      +++        ++++++++++                ++ +
 +                    +++++++++++++++++++++              +++  +
  ++++                ++++++++++++++++++++           ++++     +
      ++++++++       +++++               +                    +
              ++++++++                      +++++++           +
                                                              +
                                                              +
                                                              +
                                                              +
                                                              +
                                                              +
                                                              +
                                                              +
                                                              +
                                                              +
                                                              +
                                                              +
+++++++++++++++++++++++++++++++++++++++++++++++++++++++++++++++
