+------------------------------------------------+
|                                                |
|                                                |
|                                                |
|                   +--------+                   |
|                   |++++++++|                   |
|                   |++++++++|                   |
|        |          +--------+           |       |
|         \                             /        |
|         |                            /         |
|          \                          /          |
|          |                          |          |
|           \                        /           |
|           |                       /            |
|            \                     /             |
|            |                    /              |
|             \                  /               |
|             |                 /                |
|              \                |                |
|              |               /                 |
|               \             /                  |
|               |            /                   |
|                \                               |
|                                                |
|                                                |
|                                                |
|                                                |
|                                                |
|                            \                   |
|                |            |                  |
|               /             \                  |
|               |              \                 |
|              /                |                |
|             /                 \                |
|             |                  \               |
|            /                    |              |
|           /       +-----+       \              |
|           |       |-----|        \             |
|          /        |-----|         |            |
|         /         +-----+         \            |
|         |                          \           |
|        /                            |          |
|       /                             \          |
|       |                              |         |
|      /                                         |
|                                                |
|                                                |
|                                                |
|                                                |
+------------------------------------------------+
