+------------------------------------------------+
|      +                                         |
|      -                                         |
|       \-                                       |
|         \------------------------              |
|          |\-                                   |
|          |                                     |
|          |    \-------------------             |
|          |     |\-                             |
|          |     |  \-                           |
|          |     |   +\--------------            |
|                    |  \-                       |
|                    |    \-                     |
|                    |      \-                   |
|                                                |
|          |     |                               |
|          |     |                               |
|          |     +-------------------            |
|          |                                     |
|          |                                     |
|          |                                     |
|          +--------------------------           |
|                                                |
|                                                |
|                 |     |                        |
|                 |     |                        |
|                 |     |                        |
|             ----------------                   |
|                 |     |                        |
|                 |     |                        |
|                 |     |                        |
|                 |     |                        |
|       ----------+     +-----------             |
|                                                |
|                                                |
|                         ----------------+      |
|                                         |      |
|         |                               |      |
|         |                               |      |
|         |                               |      |
|         |        |                      |      |
|         |        |                      |      |
|         +--------|-------               |      |
|                  |                      |      |
|                  |                             |
|                  |                             |
|                                                |
|                                                |
|                                                |
+------------------------------------------------+
