+------------------------------------------------+
|                                                |
|           \                                    |
|            -\                                  |
|              -\                                |
|                \                               |
|         |       -\                             |
|        / \        -\                           |
|        |  -\        -\                         |
|       /     -\        \                        |
|       |       \        -\                      |
|      /         -\        -\                    |
|      |           -\        \                   |
|     /              \        -\                 |
|     |       -\      -\        -\               |
|    /       /  -\      -\        \              |
|    |      /     \       -\       -\            |
|   /      /       \        \        -\          |
|   |     /         -\       -\        -\        |
|  /     /            \        -\        \       |
|  |    /              -\        \        -\     |
| /    /                 \        -\        -\   |
| |   -            -\     \         -\        -  |
| -    \         -/  \     -\         -      /   |
|  \    \       -/    -      -       /      |    |
|   \    \       \-         /       |       /    |
|    \    \-       \       /        /      /     |
| -   \     \       \     /        /      /      |
|      \     \       \-  /        |      |       |
|       \-    \        \-         /      /       |
|         \    \                 /      /        |
|          \    \               |      /         |
|           \    \              /     |          |
|            \    \            /      /          |
|             \    \          /      /           |
|              \    \-       |      /            |
|               \     \      /     |             |
|                \     \    /      /             |
|                 \     \  |      /              |
|                  \     \ /     /               |
|                   \-    |     |                |
|                     \         /                |
|                      \       /                 |
|                       \     /                  |
|                        \   |                   |
|                         \  /                   |
|                          \|                    |
|                                                |
|                                                |
+------------------------------------------------+
