+-----------------------+
|----\                  |
|     ---     -\        |
|               -----   |
|                       |
|                       |
|                  /----|
|        /---------     |
|   -----               |
|                       |
|                       |
|----\                  |
|     ---------\        |
|               -----   |
|                       |
|                       |
|                  /----|
|        /---------     |
|   -----               |
|                       |
|                       |
|-----\                 |
|++++++----------\      |
|+++++++++++++++++------|
+-----------------------+
