+------------------------------------------------+
|                                                |
|                                                |
|                            --                  |
|                         --/                    |
|      ----\           --/                       |
|           ----------/                          |
|               --/ -------\                     |
|            --/            -----                |
|          -/                                    |
|                                                |
|                            /--                 |
|                        /---                    |
|                    /---                        |
|                /---                            |
|            /---                                |
|        /---                                    |
|      --                                        |
|                                                |
|                                                |
|                             --                 |
|        --\               --/                   |
|           ----\        -/                      |
|                ----\--/                        |
|                  --/----\                      |
|                -/        ----\                 |
|             --/               ---              |
|           -/                                   |
|                                                |
|                               /--              |
|                         /-----                 |
|                    /----                       |
|               /----                            |
|         /-----                                 |
|      ---                                       |
|                                                |
|        -\                   --                 |
|          ---\             -/                   |
|              ---\       -/                     |
|                  --\  -/                       |
|                     -/-\                       |
|                   -/    --\                    |
|                 -/         ---\                |
|               -/               ---\            |
|             -/                     --          |
|                                                |
|                                                |
|                                                |
|                                                |
+------------------------------------------------+
