+-----------------------+
|                       |
|                       |
|    +-------------+    |
|    |             |    |
|    |             |    |
|    +-----   -----+    |
|        |+   +|        |
|        |+   +|        |
|    |   |+   +|   |    |
|    |   |/   \|   |    |
|    |   ||   ||   |    |
|    |             |    |
|    |   ||   ||   |    |
|    |   |\   /|   |    |
|    |   |+   +|   |    |
|        |+   +|        |
|        |+   +|        |
|    +-----   -----+    |
|    |             |    |
|    |             |    |
|    +-------------+    |
|                       |
|                       |
+-----------------------+
