+---+---+---+---+---+---+---+---+---+---+---+----+
+   |               |       |                    |
+   |               |       |                    |
+   |               |       |                    |
+   +   +---+---+   +   +   +   +---+   +---+    +
|   |           |   |   |   |       |   |        |
|   |           |   |   |   |       |   |        |
|   |           |   |   |   |       |   |        |
+   +   +---+---+   +---+   +---+   +---+   +----+
|   |   |           |       |   |       |        |
|   |   |           |       |   |       |        |
|   |   |           |       |   |       |        |
+   +   +   +---+---+   +---+   +---+   +---+----+
|       |           |   |           |            |
|       |           |   |           |            |
|       |           |   |           |            |
+---+---+---+   +   +   +   +   +---+---+---+    +
|       |       |   |       |       |       |    |
|       |       |   |       |       |       |    |
|       |       |   |       |       |       |    |
+   +---+   +---+---+---+---+---+   +   +   +    +
|       |                       |       |   |    |
|       |                       |       |   |    |
|       |                       |       |   |    |
+   +   +---+---+---+---+   +---+---+   +---+    +
|   |   |       |       |   |           |        |
|   |   |       |       |   |           |        |
|   |   |       |       |   |           |        |
+---+   +   +   +   +   +   +   +---+---+   +----+
|       |   |       |   |               |   |    |
|       |   |       |   |               |   |    |
|       |   |       |   |               |   |    |
+   +---+   +---+---+---+---+   +---+   +   +    +
|   |                           |       |        |
|   |                           |       |        |
|   |                           |       |        |
+   +   +   +---+---+---+---+---+   +---+   +----+
|   |   |       |       |           |   |   |    |
|   |   |       |       |           |   |   |    |
|   |   |       |       |           |   |   |    |
+   +   +---+   +   +   +   +---+---+   +   +    +
|   |   |       |   |   |       |       |   |    |
|   |   |       |   |   |       |       |   |    |
|   |   |       |   |   |       |       |   |    |
+   +---+   +   +   +   +---+   +   +   +   +    +
|           |       |       |       |            +
|           |       |       |       |            +
|           |       |       |       |            +
|           |       |       |       |            +
+---+---+---+---+---+---+---+---+---+---+---+----+
