+++++++++++++++++++++++++++
+++          +          +++
+++ +++ ++++ + ++++ +++ +++
+++ +++ ++++ + ++++ +++ +++
+++                     +++
+++ +++ + +++++++ + +++ +++
+++     + +++++++ +     +++
+++++++ +    +    + +++++++
+++++++ ++++ + ++++ +++++++
+++++++ +         + +++++++
+++++++ + +++ +++ + +++++++
++        +     +        ++
+++++++ + +++++++ + +++++++
+++++++ +         + +++++++
+++++++ + +++++++ + +++++++
+++++++ + +++++++ + +++++++
+++          +          +++
+++ +++ ++++ + ++++ +++ +++
+++   +             +   +++
+++++ + + +++++++ + + +++++
+++     +    +    +     +++
+++     +    +    +     +++
+++ ++++++++ + ++++++++ +++
+++ ++++++++ + ++++++++ +++
+++                     +++
+++++++++++++++++++++++++++
+++++++++++++++++++++++++++
